111111111111111
1P0001C00000001
101CC1011100101
1C10000000001E1
111111111111111